length|number|1
name|string|String
prototype|object|
fromCharCode|function|function fromCharCode() 
fromCodePoint|function|function fromCodePoint() 
raw|function|function raw() 
length|number|0
name|string|
arguments
caller
constructor|function|function Function() 
apply|function|function apply() 
bind|function|function bind() 
call|function|function call() 
toString|function|function toString() 
length|number|0
constructor|function|function String() 
anchor|function|function anchor() 
big|function|function big() 
blink|function|function blink() 
bold|function|function bold() 
charAt|function|function charAt() 
charCodeAt|function|function charCodeAt() 
codePointAt|function|function codePointAt() 
concat|function|function concat() 
endsWith|function|function endsWith() 
fontcolor|function|function fontcolor() 
fontsize|function|function fontsize() 
fixed|function|function fixed() 
includes|function|function includes() 
indexOf|function|function indexOf() 
italics|function|function italics() 
lastIndexOf|function|function lastIndexOf() 
link|function|function link() 
localeCompare|function|function localeCompare() 
match|function|function match() 
normalize|function|function normalize() 
padEnd|function|function padEnd() 
padStart|function|function padStart() 
repeat|function|function repeat() 
replace|function|function replace() 
search|function|function search() 
slice|function|function slice() 
small|function|function small() 
split|function|function split() 
strike|function|function strike() 
sub|function|function sub() 
substr|function|function substr() 
substring|function|function substring() 
sup|function|function sup() 
startsWith|function|function startsWith() 
toString|function|function toString() 
trim|function|function trim() 
trimLeft|function|function trimStart() 
trimRight|function|function trimEnd() 
toLowerCase|function|function toLowerCase() 
toUpperCase|function|function toUpperCase() 
valueOf|function|function valueOf() 
toLocaleLowerCase|function|function toLocaleLowerCase() 
toLocaleUpperCase|function|function toLocaleUpperCase() 
trimStart|function|function trimStart() 
trimEnd|function|function trimEnd() 