__super__|function|function Object() 
defineMethods|function|function defineMethods(svc) 
defineService|function|function defineService(serviceIdentifier, versions, features) 
addVersions|function|function addVersions(svc, versions) 
defineServiceApi|function|function defineServiceApi(superclass, version, apiConfig) 
hasService|function|function(identifier) 
addDefaultMonitoringListeners|function|function addDefaultMonitoringListeners(attachOn) 
_serviceMap|object|[object Object]
constructor|function|function Service(config) 
initialize|function|function initialize(config) 
validateService|function|function validateService() 
loadServiceClass|function|function loadServiceClass(serviceConfig) 
getLatestServiceClass|function|function getLatestServiceClass(version) 
getLatestServiceVersion|function|function getLatestServiceVersion(version) 
api|object|[object Object]
defaultRetryCount|number|3
customizeRequests|function|function customizeRequests(callback) 
makeRequest|function|function makeRequest(operation, params, callback) 
makeUnauthenticatedRequest|function|function makeUnauthenticatedRequest(operation, params, callback) 
waitFor|function|function waitFor(state, params, callback) 
addAllRequestListeners|function|function addAllRequestListeners(request) 
apiCallEvent|function|function apiCallEvent(request) 
apiAttemptEvent|function|function apiAttemptEvent(request) 
attemptFailEvent|function|function attemptFailEvent(request) 
attachMonitoringEmitter|function|function attachMonitoringEmitter(request) 
setupRequestListeners|function|function setupRequestListeners(request) 
getSignerClass|function|function getSignerClass(request) 
serviceInterface|function|function serviceInterface() 
successfulResponse|function|function successfulResponse(resp) 
numRetries|function|function numRetries() 
retryDelays|function|function retryDelays(retryCount) 
retryableError|function|function retryableError(error) 
networkingError|function|function networkingError(error) 
timeoutError|function|function timeoutError(error) 
expiredCredentialsError|function|function expiredCredentialsError(error) 
clockSkewError|function|function clockSkewError(error) 
getSkewCorrectedDate|function|function getSkewCorrectedDate() 
applyClockOffset|function|function applyClockOffset(newServerTime) 
isClockSkewed|function|function isClockSkewed(newServerTime) 
throttledError|function|function throttledError(error) 
endpointFromTemplate|function|function endpointFromTemplate(endpoint) 
setEndpoint|function|function setEndpoint(endpoint) 
paginationConfig|function|function paginationConfig(operation, throwException) 
listeners|function|function listeners(eventName) 
on|function|function on(eventName, listener, toHead) 
onAsync|function|function onAsync(eventName, listener, toHead) 
removeListener|function|function removeListener(eventName, listener) 
removeAllListeners|function|function removeAllListeners(eventName) 
emit|function|function emit(eventName, eventArgs, doneCallback) 
callListeners|function|function callListeners(listeners, args, doneCallback, prevError) 
addListeners|function|function addListeners(listeners) 
addNamedListener|function|function addNamedListener(name, eventName, callback, toHead) 
addNamedAsyncListener|function|function addNamedAsyncListener(name, eventName, callback, toHead) 
addNamedListeners|function|function addNamedListeners(callback) 
addListener|function|function on(eventName, listener, toHead) 
_events|object|[object Object]
publisher|object|[object Object]